1111111111111
10010C0000001
1000011111001
1P010000000E1
1111111111111
