1111111111111111111111111111111111
1E0000000000000C000000001001001001
101P010100100000101111001001001001
1010010010101010001111001001001001
100000000C00C000000000001001001001
1111111111111111111111111111111111